NO ../cub3d/assets/imgs/wall_04.xpm
SO ../cub3d/assets/imgs/wall_03.xpm
WE ../cub3d/assets/imgs/wall_02.xpm
EA ../cub3d/assets/imgs/wall_01.xpm

F 226,114,91
C 135,206,235

1111111111111111
100N000000000001
1000001110000001
1000000000000001
1000000111011111
1011100011000001
1001000111001001
1000000000001001
1001111000001001
1000000000000001
1111111111111111
