NO assets/imgs/valid_path
SO assets/imgs/valid_path
WE assets/imgs/valid_path
EA assets/imgs/valid_path

F 220,100,0
C 225,30,0

111111111111111111
100000010000000N01
100000010000000001
100000000000000001
100000000000000001
100000000000000001
100000000000000001
100000000000000001
100000000000000001
100000000000001001
100001000000001001
100000000000001001
100000000000001001
111111111111111111
