NO assets/imgs/valid_path
SO assets/imgs/valid_path
WE assets/imgs/valid_path
EA assets/imgs/valid_path

F 220,100,0
C 225,30,0

1111111111111111
1000000000000001
1000001110000001
1000000N00000001
1000000000011111
1011100000000001
1001000000001001
1000000000001001
1001111000001001
1000000000000001
1111111111111111
